CVEGEO,Nombre,POB_1995,POB_2000,POB_2005,POB_2010,hombres15,mujeres15,POB_2015,prom
20001,Abejones,967,1540,1144,1084,370,512,882,1183.75
20002,Acatlán de Pérez Figueroa,44006,44579,42347,44885,22376,23507,45883,43954.25
20003,Asunción Cacalotepec,2631,2567,2095,2495,984,1043,2027,2447
20004,Asunción Cuyotepeji,845,883,753,1012,437,493,930,873.25
20005,Asunción Ixtaltepec,15537,14249,14438,14751,7485,7620,15105,14743.75
20006,Asunción Nochixtlán,12299,13745,14676,17820,8588,9937,18525,14635
20007,Asunción Ocotlán,3982,3655,3257,2612,1156,1394,2550,3376.5
20008,Asunción Tlacolulita,958,918,699,842,366,392,758,854.25
20009,Ayotzintepec,5087,5660,6524,6720,3506,3596,7102,5997.75
20010,El Barrio de la Soledad,13041,13186,13439,13608,6809,7468,14277,13318.5
20011,Calihualá,1298,1317,1057,1220,568,614,1182,1223
20012,Candelaria Loxicha,8124,9566,8686,9860,5151,5346,10497,9059
20013,Ciénega de Zimatlán,3075,2942,2562,2785,1415,1538,2953,2841
20014,Ciudad Ixtepec,21498,22675,24181,26450,13606,15031,28637,23701
20015,Coatecas Altas,5216,5803,4882,4712,2258,2565,4823,5153.25
20016,Coicoyán de las Flores,4862,5733,7598,8531,4672,5264,9936,6681
20017,La Compañía,4174,3998,3367,3302,1626,1739,3365,3710.25
20018,Concepción Buenavista,1004,946,828,834,397,406,803,903
20019,Concepción Pápalo,3382,3077,2920,3071,1448,1486,2934,3112.5
20020,Constancia del Rosario,2976,3295,3796,3860,1821,2126,3947,3481.75
20021,Cosolapa,14547,14467,14305,14667,7538,8328,15866,14496.5
20022,Cosoltepec,1065,931,1022,866,338,378,716,971
20023,Cuilápam de Guerrero,11235,12812,15041,18428,10475,11122,21597,14379
20024,Cuyamecalco Villa de Zaragoza,4094,4298,3783,3846,1825,1818,3643,4005.25
20025,Chahuites,9266,9799,9929,11105,5626,5787,11413,10024.75
20026,Chalcatongo de Hidalgo,7881,7828,7483,8481,4256,4810,9066,7918.25
20027,Chiquihuitlán de Benito Juárez,2551,2501,2368,2458,999,1252,2251,2469.5
20028,Heroica Ciudad de Ejutla de Crespo,18404,17573,17232,19679,9876,11039,20915,18222
20029,Eloxochitlán de Flores Magón,3124,4149,4042,4263,1930,2205,4135,3894.5
20030,El Espinal,7921,7705,8219,8310,4180,4395,8575,8038.75
20031,Tamazulápam del Espíritu Santo,5391,6704,6908,7362,3106,3996,7102,6591.25
20032,Fresnillo de Trujano,1017,1138,852,1033,485,511,996,1010
20033,Guadalupe Etla,1770,2004,2349,2433,1236,1401,2637,2139
20034,Guadalupe de Ramírez,1309,1400,1214,1425,563,609,1172,1337
20035,Guelatao de Juárez,655,754,476,544,254,277,531,607.25
20036,Guevea de Humboldt,5724,5610,5283,5285,2589,2820,5409,5475.5
20037,Mesones Hidalgo,3955,4185,3961,4402,2033,2347,4380,4125.75
20038,Villa Hidalgo,2287,2132,1955,2112,909,1008,1917,2121.5
20039,Heroica Ciudad de Huajuapan de León,47827,53219,57808,69839,36429,41118,77547,57173.25
20040,Huautepec,5441,6567,5672,5995,2928,3371,6299,5918.75
20041,Huautla de Jiménez,27206,31040,31829,30004,14636,16915,31551,30019.75
20042,Ixtlán de Juárez,6689,7287,7188,7674,4035,4233,8268,7209.5
20043,Heroica Ciudad de Juchitán de Zaragoza,75946,78512,85869,93038,47156,50887,98043,83341.25
20044,Loma Bonita,41744,40877,39166,41535,20397,22487,42884,40830.5
20045,Magdalena Apasco,3845,3942,6148,7522,3933,4370,8303,5364.25
20046,Magdalena Jaltepec,3752,3717,3463,3313,1451,1698,3149,3561.25
20047,Santa Magdalena Jicotlán,121,109,102,93,39,48,87,106.25
20048,Magdalena Mixtepec,917,946,1101,1304,662,713,1375,1067
20049,Magdalena Ocotlán,959,1029,1060,1141,554,592,1146,1047.25
20050,Magdalena Peñasco,2998,3473,3461,3778,1565,1816,3381,3427.5
20051,Magdalena Teitipac,3299,3604,4296,4368,2227,2336,4563,3891.75
20052,Magdalena Tequisistlán,6625,6011,6014,6182,2931,3107,6038,6208
20053,Magdalena Tlacotepec,1225,1116,1165,1221,585,635,1220,1181.75
20054,Magdalena Zahuatlán,469,434,422,409,196,219,415,433.5
20055,Mariscala de Juárez,3292,3383,3140,3530,1674,1812,3486,3336.25
20056,Mártires de Tacubaya,1417,1275,1189,1451,672,752,1424,1333
20057,Matías Romero Avendaño,40018,40709,38421,38019,19259,20569,39828,39291.75
20058,Mazatlán Villa de Flores,13102,13947,12934,13435,6456,6641,13097,13354.5
20059,Miahuatlán de Porfirio Díaz,28918,32555,32185,41387,19793,22519,42312,33761.25
20060,Mixistlán de la Reforma,2552,2666,2438,2770,1220,1365,2585,2606.5
20061,Monjas,2150,2392,2104,2568,1256,1466,2722,2303.5
20062,Natividad,624,579,546,586,211,264,475,583.75
20063,Nazareno Etla,2961,3368,3720,3882,1867,2043,3910,3482.75
20064,Nejapa de Madero,7930,7607,7285,7390,3627,3758,7385,7553
20065,Ixpantepec Nieves,2030,1835,1371,1182,538,671,1209,1604.5
20066,Santiago Niltepec,5693,5308,4961,5353,2639,2688,5327,5328.75
20067,Oaxaca de Juárez,244827,256130,265006,263357,119946,144305,264251,257330
20068,Ocotlán de Morelos,17180,18183,19581,21341,10306,11370,21676,19071.25
20069,La Pe,1747,2032,2135,2446,1275,1357,2632,2090
20070,Pinotepa de Don Luis,5841,6226,6703,6629,3379,3514,6893,6349.75
20071,Pluma Hidalgo,3442,3828,3314,3060,1382,1489,2871,3411
20072,San José del Progreso,5570,5661,6164,6579,3297,3525,6822,5993.5
20073,Putla Villa de Guerrero,26154,26406,29678,31897,15250,17390,32640,28533.75
20074,Santa Catarina Quioquitani,355,424,439,505,240,242,482,430.75
20075,Reforma de Pineda,2580,2675,2691,2671,1302,1421,2723,2654.25
20076,La Reforma,3338,3548,3096,3331,1566,1690,3256,3328.25
20077,Reyes Etla,2566,2423,3252,3568,1829,1928,3757,2952.25
20078,Rojas de Cuauhtémoc,1047,1061,964,1092,510,585,1095,1041
20079,Salina Cruz,76198,76452,76219,82371,42336,46875,89211,77810
20080,San Agustín Amatengo,1883,1796,1455,1312,694,765,1459,1611.5
20081,San Agustín Atenango,2422,2318,1787,1914,817,943,1760,2110.25
20082,San Agustín Chayuco,4568,4594,4514,3952,1976,2123,4099,4407
20083,San Agustín de las Juntas,3898,4970,5645,8089,4508,4834,9342,5650.5
20084,San Agustín Etla,2952,3206,3243,3893,1891,2093,3984,3323.5
20085,San Agustín Loxicha,18839,22495,17823,22565,11979,12488,24467,20430.5
20086,San Agustín Tlacotepec,824,751,876,874,405,524,929,831.25
20087,San Agustín Yatareni,2910,3400,3176,4075,2000,2334,4334,3390.25
20088,San Andrés Cabecera Nueva,3266,3100,2529,2851,1388,1431,2819,2936.5
20089,San Andrés Dinicuiti,2156,2136,2114,2152,1033,1079,2112,2139.5
20090,San Andrés Huaxpaltepec,5354,5638,5756,5867,2963,3205,6168,5653.75
20091,San Andrés Huayápam,3199,3909,4508,4879,2558,2778,5336,4123.75
20092,San Andrés Ixtlahuaca,1474,1377,1343,1439,759,845,1604,1408.25
20093,San Andrés Lagunas,610,563,528,505,220,263,483,551.5
20094,San Andrés Nuxiño,2168,2067,1983,1898,842,914,1756,2029
20095,San Andrés Paxtlán,2884,3723,4066,3990,2129,2166,4295,3665.75
20096,San Andrés Sinaxtla,700,677,613,772,335,381,716,690.5
20097,San Andrés Solaga,1869,1678,1699,1740,821,850,1671,1746.5
20098,San Andrés Teotilálpam,4070,4295,4255,4427,2102,2323,4425,4261.75
20099,San Andrés Tepetlapa,352,548,485,475,227,245,472,465
20100,San Andrés Yaá,609,537,378,497,191,231,422,505.25
20101,San Andrés Zabache,1051,916,756,726,335,404,739,862.25
20102,San Andrés Zautla,2910,3074,3812,4405,2106,2303,4409,3550.25
20103,San Antonino Castillo Velasco,4739,4809,4829,5651,2849,3160,6009,5007
20104,San Antonino el Alto,1866,1929,2445,2508,1287,1319,2606,2187
20105,San Antonino Monte Verde,5585,6200,6482,6650,3332,3973,7305,6229.25
20106,San Antonio Acutla,331,339,311,297,116,133,249,319.5
20107,San Antonio de la Cal,11214,15261,15071,21456,10809,12229,23038,15750.5
20108,San Antonio Huitepec,4346,4315,4303,4289,2015,2406,4421,4313.25
20109,San Antonio Nanahuatípam,1266,1313,1256,1233,608,619,1227,1267
20110,San Antonio Sinicahua,1228,1362,1298,1603,667,817,1484,1372.75
20111,San Antonio Tepetlapa,3527,3818,3873,4394,2033,2212,4245,3903
20112,San Baltazar Chichicápam,2953,2881,2716,2439,1174,1320,2494,2747.25
20113,San Baltazar Loxicha,2662,2873,2751,2832,1446,1550,2996,2779.5
20114,San Baltazar Yatzachi el Bajo,780,788,690,677,303,338,641,733.75
20115,San Bartolo Coyotepec,4083,4740,8015,8684,4309,4796,9105,6380.5
20116,San Bartolomé Ayautla,2871,3833,3713,4052,2117,2298,4415,3617.25
20117,San Bartolomé Loxicha,2275,2512,2617,2422,1146,1191,2337,2456.5
20118,San Bartolomé Quialana,2534,2731,2485,2470,1030,1446,2476,2555
20119,San Bartolomé Yucuañe,546,523,380,399,164,222,386,462
20120,San Bartolomé Zoogocho,730,638,381,368,143,191,334,529.25
20121,San Bartolo Soyaltepec,895,827,681,655,296,358,654,764.5
20122,San Bartolo Yautepec,772,752,661,677,318,318,636,715.5
20123,San Bernardo Mixtepec,3028,2727,2394,2705,1313,1428,2741,2713.5
20124,San Blas Atempa,14453,15886,16899,17094,9153,9253,18406,16083
20125,San Carlos Yautepec,10988,10882,9857,11813,6083,6018,12101,10885
20126,San Cristóbal Amatlán,3801,4236,3978,5024,2402,2746,5148,4259.75
20127,San Cristóbal Amoltepec,1101,1180,1179,1283,442,562,1004,1185.75
20128,San Cristóbal Lachirioag,1264,1252,1130,1230,586,620,1206,1219
20129,San Cristóbal Suchixtlahuaca,328,344,244,334,179,181,360,312.5
20130,San Dionisio del Mar,4438,4931,5165,5098,2605,2522,5127,4908
20131,San Dionisio Ocotepec,9004,9788,9487,10500,4961,5667,10628,9694.75
20132,San Dionisio Ocotlán,1136,1043,1093,1245,522,555,1077,1129.25
20133,San Esteban Atatlahuca,3443,3408,3676,3974,1746,1850,3596,3625.25
20134,San Felipe Jalapa de Díaz,19040,23238,25395,26838,13245,14734,27979,23627.75
20135,San Felipe Tejalápam,5815,6150,6221,7187,3715,4147,7862,6343.25
20136,San Felipe Usila,10597,11680,11642,11575,5519,6085,11604,11373.5
20137,San Francisco Cahuacuá,2998,3324,3170,3427,1679,1700,3379,3229.75
20138,San Francisco Cajonos,733,472,371,460,213,227,440,509
20139,San Francisco Chapulapa,1967,1914,1968,2136,981,1064,2045,1996.25
20140,San Francisco Chindúa,735,783,673,827,399,392,791,754.5
20141,San Francisco del Mar,4850,5782,6874,7232,3826,3824,7650,6184.5
20142,San Francisco Huehuetlán,1028,1379,1251,1160,446,545,991,1204.5
20143,San Francisco Ixhuatán,9313,9318,9050,8959,4448,4532,8980,9160
20144,San Francisco Jaltepetongo,1256,1184,881,1110,462,487,949,1107.75
20145,San Francisco Lachigoló,1616,1789,1920,3474,1857,1997,3854,2199.75
20146,San Francisco Logueche,1722,1868,2240,2666,1311,1476,2787,2124
20147,San Francisco Nuxaño,424,413,341,378,188,179,367,389
20148,San Francisco Ozolotepec,1879,1991,1835,1945,947,993,1940,1912.5
20149,San Francisco Sola,1221,1250,1321,1509,811,920,1731,1325.25
20150,San Francisco Telixtlahuaca,8681,9694,10278,11893,6153,6741,12894,10136.5
20151,San Francisco Teopan,427,452,390,394,171,152,323,415.75
20152,San Francisco Tlapancingo,1688,2064,1235,2152,932,1177,2109,1784.75
20153,San Gabriel Mixtepec,3519,3959,3930,4733,2355,2481,4836,4035.25
20154,San Ildefonso Amatlán,1980,1938,2009,2393,1120,1287,2407,2080
20155,San Ildefonso Sola,840,849,789,940,496,489,985,854.5
20156,San Ildefonso Villa Alta,3164,3294,3100,3478,1599,1717,3316,3259
20157,San Jacinto Amilpas,3834,8343,10100,13860,7473,8247,15720,9034.25
20158,San Jacinto Tlacotepec,2108,2355,2145,2231,1086,1172,2258,2209.75
20159,San Jerónimo Coatlán,3580,5227,4979,5449,2430,2589,5019,4808.75
20160,San Jerónimo Silacayoapilla,1901,1895,1742,1449,682,709,1391,1746.75
20161,San Jerónimo Sosola,2620,2717,2736,2559,1185,1332,2517,2658
20162,San Jerónimo Taviche,1491,1529,1750,1848,933,1001,1934,1654.5
20163,San Jerónimo Tecóatl,1542,1702,1522,1606,735,855,1590,1593
20164,San Jorge Nuchita,3321,3353,2957,3215,1253,1519,2772,3211.5
20165,San José Ayuquila,1288,1271,1342,1511,699,813,1512,1353
20166,San José Chiltepec,9612,9867,10203,11019,5899,6199,12098,10175.25
20167,San José del Peñasco,1362,1892,1863,2094,988,1047,2035,1802.75
20168,San José Estancia Grande,877,916,955,977,528,531,1059,931.25
20169,San José Independencia,4100,4538,3689,3684,1861,2006,3867,4002.75
20170,San José Lachiguiri,3399,3151,3541,3849,1459,1792,3251,3485
20171,San José Tenango,16449,19969,18120,18478,8687,9629,18316,18254
20172,San Juan Achiutla,455,531,401,430,185,191,376,454.25
20173,San Juan Atepec,1678,1572,1301,1517,687,775,1462,1517
20174,Ánimas Trujano,2514,2887,3189,3759,1834,2083,3917,3087.25
20175,San Juan Bautista Atatlahuca,1680,1775,1384,1724,764,819,1583,1640.75
20176,San Juan Bautista Coixtlahuaca,3398,3223,2863,2808,1276,1411,2687,3073
20177,San Juan Bautista Cuicatlán,9226,9298,9181,9441,4772,5173,9945,9286.5
20178,San Juan Bautista Guelache,3131,3499,4912,6287,3253,3621,6874,4457.25
20179,San Juan Bautista Jayacatlán,1447,1236,1254,1462,729,727,1456,1349.75
20180,San Juan Bautista Lo de Soto,2653,2286,2140,2325,1291,1302,2593,2351
20181,San Juan Bautista Suchitepec,515,442,412,417,207,233,440,446.5
20182,San Juan Bautista Tlacoatzintepec,2182,2242,2241,2292,1020,1158,2178,2239.25
20183,San Juan Bautista Tlachichilco,1367,1511,1443,1447,629,754,1383,1442
20184,San Juan Bautista Tuxtepec,127707,133913,144555,155766,76949,85562,162511,140485.25
20185,San Juan Cacahuatepec,7812,7514,8134,8680,4307,4548,8855,8035
20186,San Juan Cieneguilla,593,666,556,605,256,291,547,605
20187,San Juan Coatzóspam,2176,2479,2019,2535,879,929,1808,2302.25
20188,San Juan Colorado,7801,8656,8669,9494,4844,5186,10030,8655
20189,San Juan Comaltepec,1937,2338,2389,2517,1406,1464,2870,2295.25
20190,San Juan Cotzocón,21362,21679,22478,22356,11398,12288,23686,21968.75
20191,San Juan Chicomezúchil,365,374,281,320,150,180,330,335
20192,San Juan Chilateca,1303,1338,1323,1442,686,808,1494,1351.5
20193,San Juan del Estado,2134,2285,2200,2546,1246,1346,2592,2291.25
20194,San Juan del Río,1277,1350,1227,1231,567,670,1237,1271.25
20195,San Juan Diuxi,1784,1468,1280,1256,524,547,1071,1447
20196,San Juan Evangelista Analco,524,422,412,404,196,217,413,440.5
20197,San Juan Guelavía,2811,2914,2940,3047,1539,1673,3212,2928
20198,San Juan Guichicovi,25096,27399,27646,28142,13789,15575,29364,27070.75
20199,San Juan Ihualtepec,751,849,717,713,272,308,580,757.5
20200,San Juan Juquila Mixes,3517,3588,3557,3924,1770,1956,3726,3646.5
20201,San Juan Juquila Vijanos,1672,1830,1908,1832,931,1022,1953,1810.5
20202,San Juan Lachao,3340,4302,3936,4531,2255,2422,4677,4027.25
20203,San Juan Lachigalla,2740,3198,3363,3285,1550,1727,3277,3146.5
20204,San Juan Lajarcia,737,675,674,715,270,337,607,700.25
20205,San Juan Lalana,15321,16775,16335,17398,8257,8715,16972,16457.25
20206,San Juan de los Cués,2583,2466,2447,2357,1198,1246,2444,2463.25
20207,San Juan Mazatlán,16547,17090,16138,17100,9470,9693,19163,16718.75
20208,San Juan Mixtepec,9246,9543,7423,7611,3113,3567,6680,8455.75
20209,San Juan Mixtepec,714,932,903,711,285,375,660,815
20210,San Juan Ñumí,6221,6750,5796,6666,2564,3183,5747,6358.25
20211,San Juan Ozolotepec,3009,3125,2779,3168,1326,1338,2664,3020.25
20212,San Juan Petlapa,2091,2551,2717,2807,1405,1514,2919,2541.5
20213,San Juan Quiahije,3570,3889,4154,3628,1991,2295,4286,3810.25
20214,San Juan Quiotepec,2367,2486,2429,2313,960,1019,1979,2398.75
20215,San Juan Sayultepec,660,665,655,764,358,430,788,686
20216,San Juan Tabaá,1130,1150,1091,1331,606,674,1280,1175.5
20217,San Juan Tamazola,3379,3454,3170,3446,1393,1484,2877,3362.25
20218,San Juan Teita,455,572,511,607,262,269,531,536.25
20219,San Juan Teitipac,2945,2817,2552,2565,1249,1370,2619,2719.75
20220,San Juan Tepeuxila,3045,2974,2914,2773,1338,1301,2639,2926.5
20221,San Juan Teposcolula,1393,1448,1344,1340,604,624,1228,1381.25
20222,San Juan Yaeé,1491,1605,1495,1530,697,784,1481,1530.25
20223,San Juan Yatzona,504,496,561,452,206,268,474,503.25
20224,San Juan Yucuita,743,720,656,684,260,307,567,700.75
20225,San Lorenzo,5047,5380,5781,5955,2919,3182,6101,5540.75
20226,San Lorenzo Albarradas,2524,2587,2477,2708,1381,1342,2723,2574
20227,San Lorenzo Cacaotepec,8341,9965,11559,13704,7478,8257,15735,10892.25
20228,San Lorenzo Cuaunecuiltitla,598,737,738,771,422,385,807,711
20229,San Lorenzo Texmelúcan,4703,5676,6319,7048,3861,4462,8323,5936.5
20230,San Lorenzo Victoria,1084,1202,948,1007,470,472,942,1060.25
20231,San Lucas Camotlán,2568,3144,2524,3026,1421,1540,2961,2815.5
20232,San Lucas Ojitlán,18449,20118,19871,21514,9618,10467,20085,19988
20233,San Lucas Quiaviní,2088,1941,1769,1745,727,1009,1736,1885.75
20234,San Lucas Zoquiápam,6139,7227,7384,7554,3503,3747,7250,7076
20235,San Luis Amatlán,3771,3618,3393,3624,1673,1969,3642,3601.5
20236,San Marcial Ozolotepec,1736,1741,1399,1525,736,821,1557,1600.25
20237,San Marcos Arteaga,2223,2303,2110,1557,663,759,1422,2048.25
20238,San Martín de los Cansecos,828,757,761,816,420,431,851,790.5
20239,San Martín Huamelúlpam,1022,1078,1012,1077,471,539,1010,1047.25
20240,San Martín Itunyoso,2299,2614,2554,2460,1028,1270,2298,2481.75
20241,San Martín Lachilá,1288,1200,979,1084,488,599,1087,1137.75
20242,San Martín Peras,7742,8877,12406,11361,5841,6405,12246,10096.5
20243,San Martín Tilcajete,1649,1776,1631,1742,823,998,1821,1699.5
20244,San Martín Toxpalan,2910,3254,3595,3669,1832,1955,3787,3357
20245,San Martín Zacatepec,1399,1370,1199,1277,630,635,1265,1311.25
20246,San Mateo Cajonos,620,642,574,620,285,331,616,614
20247,Capulálpam de Méndez,1377,1391,1313,1467,687,862,1549,1387
20248,San Mateo del Mar,9522,10657,12667,14252,7484,7351,14835,11774.5
20249,San Mateo Yoloxochitlán,2934,2913,3294,3475,1697,1917,3614,3154
20250,San Mateo Etlatongo,1121,1108,1085,1181,540,567,1107,1123.75
20251,San Mateo Nejápam,1147,1150,1127,1180,541,603,1144,1151
20252,San Mateo Peñasco,1563,1838,1732,2116,962,1100,2062,1812.25
20253,San Mateo Piñas,4343,4148,2647,2226,1036,1048,2084,3341
20254,San Mateo Río Hondo,3642,3495,2806,3308,1526,1607,3133,3312.75
20255,San Mateo Sindihui,1867,1945,1871,2086,944,1075,2019,1942.25
20256,San Mateo Tlapiltepec,278,250,226,234,105,119,224,247
20257,San Melchor Betaza,1027,1122,919,1091,459,527,986,1039.75
20258,San Miguel Achiutla,824,880,799,744,345,367,712,811.75
20259,San Miguel Ahuehuetitlán,2130,2261,2226,2465,1119,1241,2360,2270.5
20260,San Miguel Aloápam,2461,2621,2637,2488,1000,1172,2172,2551.75
20261,San Miguel Amatitlán,6139,6143,5938,7244,3539,4010,7549,6366
20262,San Miguel Amatlán,1244,1089,1012,1043,480,513,993,1097
20263,San Miguel Coatlán,2880,3134,2808,3483,1482,1696,3178,3076.25
20264,San Miguel Chicahua,2200,2276,2035,2274,947,1150,2097,2196.25
20265,San Miguel Chimalapa,6013,5947,6541,6608,3458,3359,6817,6277.25
20266,San Miguel del Puerto,8098,8584,7510,8481,4088,4274,8362,8168.25
20267,San Miguel del Río,302,307,275,294,123,121,244,294.5
20268,San Miguel Ejutla,882,884,778,916,470,544,1014,865
20269,San Miguel el Grande,4128,3635,3086,4127,1913,2196,4109,3744
20270,San Miguel Huautla,1671,1703,1237,1399,499,595,1094,1502.5
20271,San Miguel Mixtepec,2168,2097,2387,3245,1295,1349,2644,2474.25
20272,San Miguel Panixtlahuaca,5226,6705,5724,6161,2828,3594,6422,5954
20273,San Miguel Peras,3148,3205,3126,3497,1575,1712,3287,3244
20274,San Miguel Piedras,1358,1193,1375,1296,605,666,1271,1305.5
20275,San Miguel Quetzaltepec,5303,5332,6015,7293,4027,4092,8119,5985.75
20276,San Miguel Santa Flor,1160,874,795,801,356,346,702,907.5
20277,Villa Sola de Vega,12414,12668,11884,12525,6103,6322,12425,12372.75
20278,San Miguel Soyaltepec,33887,36036,34842,36564,19041,20639,39680,35332.25
20279,San Miguel Suchixtepec,2677,2617,2694,2911,1232,1433,2665,2724.75
20280,Villa Talea de Castro,2685,2673,2237,2394,1087,1192,2279,2497.25
20281,San Miguel Tecomatlán,262,268,219,308,138,128,266,264.25
20282,San Miguel Tenango,989,821,684,794,365,364,729,822
20283,San Miguel Tequixtepec,1093,1038,964,1042,471,526,997,1034.25
20284,San Miguel Tilquiápam,3398,3160,3442,3160,1391,1758,3149,3290
20285,San Miguel Tlacamama,2860,3115,3074,3386,1798,1864,3662,3108.75
20286,San Miguel Tlacotepec,3335,3525,3307,3220,1485,1679,3164,3346.75
20287,San Miguel Tulancingo,490,432,336,346,123,173,296,401
20288,San Miguel Yotao,498,601,632,611,273,320,593,585.5
20289,San Nicolás,1248,1131,1037,1143,517,618,1135,1139.75
20290,San Nicolás Hidalgo,860,991,936,1012,452,523,975,949.75
20291,San Pablo Coatlán,3862,4069,3876,4167,2066,2179,4245,3993.5
20292,San Pablo Cuatro Venados,1334,1294,1267,1388,658,753,1411,1320.75
20293,San Pablo Etla,4670,7103,12212,15535,7520,8473,15993,9880
20294,San Pablo Huitzo,4969,5071,5928,6307,3245,3779,7024,5568.75
20295,San Pablo Huixtepec,8307,8470,8216,9025,4435,4878,9313,8504.5
20296,San Pablo Macuiltianguis,1265,1135,956,929,447,443,890,1071.25
20297,San Pablo Tijaltepec,2252,2489,2529,2150,1166,1338,2504,2355
20298,San Pablo Villa de Mitla,10642,10477,11219,11825,5955,6556,12511,11040.75
20299,San Pablo Yaganiza,1080,1074,1000,1108,503,560,1063,1065.5
20300,San Pedro Amuzgos,4949,5334,5473,6468,3059,3605,6664,5556
20301,San Pedro Apóstol,1706,1471,1511,1544,704,801,1505,1558
20302,San Pedro Atoyac,3500,3765,3464,4136,2117,2422,4539,3716.25
20303,San Pedro Cajonos,1307,1204,989,1172,507,582,1089,1168
20304,San Pedro Coxcaltepec Cántaros,1077,1050,877,851,352,383,735,963.75
20305,San Pedro Comitancillo,3867,3634,3858,3944,2020,2214,4234,3825.75
20306,San Pedro el Alto,3570,4735,3949,3903,1699,1852,3551,4039.25
20307,San Pedro Huamelula,8865,9862,8834,9594,4940,5074,10014,9288.75
20308,San Pedro Huilotepec,2396,2588,2671,2839,1546,1600,3146,2623.5
20309,San Pedro Ixcatlán,9858,10854,10931,10371,5590,6063,11653,10503.5
20310,San Pedro Ixtlahuaca,3174,3604,5321,6822,4147,4414,8561,4730.25
20311,San Pedro Jaltepetongo,663,677,271,458,258,287,545,517.25
20312,San Pedro Jicayán,9388,9770,10252,11555,5806,6581,12387,10241.25
20313,San Pedro Jocotipac,1122,1010,821,834,358,421,779,946.75
20314,San Pedro Juchatengo,1590,1548,1618,1693,737,824,1561,1612.25
20315,San Pedro Mártir,1943,1903,1781,1711,770,924,1694,1834.5
20316,San Pedro Mártir Quiechapa,776,821,722,753,337,356,693,768
20317,San Pedro Mártir Yucuxaco,1544,1555,1360,1405,560,679,1239,1466
20318,San Pedro Mixtepec,27111,32471,33682,42860,23381,24955,48336,34031
20319,San Pedro Mixtepec,1227,1244,1066,1099,523,551,1074,1159
20320,San Pedro Molinos,768,653,737,723,327,341,668,720.25
20321,San Pedro Nopala,1031,926,834,840,342,378,720,907.75
20322,San Pedro Ocopetatillo,815,877,897,884,365,425,790,868.25
20323,San Pedro Ocotepec,1807,1780,2171,2135,1001,1097,2098,1973.25
20324,San Pedro Pochutla,30911,36982,38798,43860,23090,24386,47476,37637.75
20325,San Pedro Quiatoni,8036,9570,9824,10491,5199,5611,10810,9480.25
20326,San Pedro Sochiápam,4459,4535,4603,4957,2511,2623,5134,4638.5
20327,San Pedro Tapanatepec,14203,13377,13647,13992,7469,7683,15152,13804.75
20328,San Pedro Taviche,919,1052,1076,1173,598,610,1208,1055
20329,San Pedro Teozacoalco,1356,1428,1298,1320,597,628,1225,1350.5
20330,San Pedro Teutila,3591,4173,4139,4277,2062,2170,4232,4045
20331,San Pedro Tidaá,926,850,646,894,407,466,873,829
20332,San Pedro Topiltepec,452,420,372,406,162,181,343,412.5
20333,San Pedro Totolápam,3017,2684,2644,2603,1254,1372,2626,2737
20334,Villa de Tututepec,40501,42645,40767,43913,22530,23622,46152,41956.5
20335,San Pedro Yaneri,930,991,943,1002,434,476,910,966.5
20336,San Pedro Yólox,2572,2546,2758,2267,825,873,1698,2535.75
20337,San Pedro y San Pablo Ayutla,4767,5504,4319,5602,2220,2593,4813,5048
20338,Villa de Etla,6319,7819,7637,9280,5020,5717,10737,7763.75
20339,San Pedro y San Pablo Teposcolula,3454,3486,3664,3989,1872,2144,4016,3648.25
20340,San Pedro y San Pablo Tequixtepec,2529,2061,1731,1878,759,921,1680,2049.75
20341,San Pedro Yucunama,262,246,244,232,102,134,236,246
20342,San Raymundo Jalpan,1555,1584,1788,2079,1514,1822,3336,1751.5
20343,San Sebastián Abasolo,2032,2029,1514,1849,925,1008,1933,1856
20344,San Sebastián Coatlán,2363,2366,2509,2613,1280,1398,2678,2462.75
20345,San Sebastián Ixcapa,3951,3722,3364,3968,1992,2080,4072,3751.25
20346,San Sebastián Nicananduta,1582,1633,1412,1449,625,816,1441,1519
20347,San Sebastián Río Hondo,2758,3288,3069,3664,1750,1837,3587,3194.75
20348,San Sebastián Tecomaxtlahuaca,8861,8671,6916,8246,3929,4423,8352,8173.5
20349,San Sebastián Teitipac,2204,2062,1962,1976,889,1078,1967,2051
20350,San Sebastián Tutla,12293,15690,15922,16241,8340,9855,18195,15036.5
20351,San Simón Almolongas,3021,2470,1847,2623,1318,1502,2820,2490.25
20352,San Simón Zahuatlán,1810,2225,2481,3833,1743,1783,3526,2587.25
20353,Santa Ana,1596,1867,1697,1978,1059,1094,2153,1784.5
20354,Santa Ana Ateixtlahuaca,559,524,572,510,263,253,516,541.25
20355,Santa Ana Cuauhtémoc,948,864,783,738,358,369,727,833.25
20356,Santa Ana del Valle,2147,2140,1996,1993,1014,1053,2067,2069
20357,Santa Ana Tavela,1137,993,1012,908,359,403,762,1012.5
20358,Santa Ana Tlapacoyan,2388,1990,1687,1854,945,1005,1950,1979.75
20359,Santa Ana Yareni,1157,1149,940,809,445,473,918,1013.75
20360,Santa Ana Zegache,3512,3415,3196,3592,1776,1997,3773,3428.75
20361,Santa Catalina Quierí,875,977,992,922,386,485,871,941.5
20362,Santa Catarina Cuixtla,1719,1545,1291,1496,630,797,1427,1512.75
20363,Santa Catarina Ixtepeji,2358,2532,2480,2633,1226,1346,2572,2500.75
20364,Santa Catarina Juquila,12560,14036,14380,14710,7619,8368,15987,13921.5
20365,Santa Catarina Lachatao,1558,1542,1097,1307,509,559,1068,1376
20366,Santa Catarina Loxicha,4375,4440,4163,3986,1880,2025,3905,4241
20367,Santa Catarina Mechoacán,3997,4230,4409,4543,2188,2272,4460,4294.75
20368,Santa Catarina Minas,1594,1604,1698,1816,953,977,1930,1678
20369,Santa Catarina Quiané,1791,1758,1571,1847,948,983,1931,1741.75
20370,Santa Catarina Tayata,773,725,596,679,304,359,663,693.25
20371,Santa Catarina Ticuá,859,858,919,954,469,562,1031,897.5
20372,Santa Catarina Yosonotú,1832,1848,1864,1886,709,847,1556,1857.5
20373,Santa Catarina Zapoquila,703,573,407,448,171,195,366,532.75
20374,Santa Cruz Acatepec,986,1263,1301,1470,728,820,1548,1255
20375,Santa Cruz Amilpas,5737,6457,8804,10120,5939,6875,12814,7779.5
20376,Santa Cruz de Bravo,447,410,379,364,168,188,356,400
20377,Santa Cruz Itundujia,9434,10688,10386,10975,5500,6116,11616,10370.75
20378,Santa Cruz Mixtepec,3284,3311,2984,3615,1624,1801,3425,3298.5
20379,Santa Cruz Nundaco,2525,2672,2692,2958,1343,1578,2921,2711.75
20380,Santa Cruz Papalutla,1699,1833,1910,1972,1036,1091,2127,1853.5
20381,Santa Cruz Tacache de Mina,2539,2625,2483,2606,1282,1393,2675,2563.25
20382,Santa Cruz Tacahua,1336,1158,1141,1170,524,592,1116,1201.25
20383,Santa Cruz Tayata,495,567,541,608,285,298,583,552.75
20384,Santa Cruz Xitla,3542,4061,3933,4514,2258,2496,4754,4012.5
20385,Santa Cruz Xoxocotlán,40815,52806,65873,77833,43478,49710,93188,59331.75
20386,Santa Cruz Zenzontepec,13978,15054,16773,17897,8987,9525,18512,15925.5
20387,Santa Gertrudis,3670,3549,2661,2858,1416,1498,2914,3184.5
20388,Santa Inés del Monte,2209,2212,2275,2535,1154,1218,2372,2307.75
20389,Santa Inés Yatzeche,1332,1177,975,921,418,534,952,1101.25
20390,Santa Lucía del Camino,35631,44364,45752,47356,23225,26234,49459,43275.75
20391,Santa Lucía Miahuatlán,2406,2808,3023,3356,1622,1739,3361,2898.25
20392,Santa Lucía Monteverde,6979,6663,6397,6678,3058,3340,6398,6679.25
20393,Santa Lucía Ocotlán,3183,3455,3580,3604,1801,2054,3855,3455.5
20394,Santa María Alotepec,2610,2660,2526,2778,1354,1412,2766,2643.5
20395,Santa María Apazco,2422,2531,1629,1898,742,978,1720,2120
20396,Santa María la Asunción,3124,3329,3223,3252,1436,1801,3237,3232
20397,Heroica Ciudad de Tlaxiaco,24784,29026,34587,38453,18550,21395,39945,31712.5
20398,Ayoquezco de Aldama,5750,5597,4385,4406,2103,2315,4418,5034.5
20399,Santa María Atzompa,11293,15749,19876,27465,16445,17670,34115,18595.75
20400,Santa María Camotlán,1507,1562,1333,1632,742,826,1568,1508.5
20401,Santa María Colotepec,15646,18120,19223,22562,11792,12284,24076,18887.75
20402,Santa María Cortijo,1124,1016,983,1083,521,554,1075,1051.5
20403,Santa María Coyotepec,1550,1658,2070,2772,1422,1549,2971,2012.5
20404,Santa María Chachoápam,850,808,750,766,347,386,733,793.5
20405,Villa de Chilapa de Díaz,1865,1711,1687,1932,947,1163,2110,1798.75
20406,Santa María Chilchotla,18745,21436,20577,20584,9854,10474,20328,20335.5
20407,Santa María Chimalapa,7080,7106,8643,8506,4569,4509,9078,7833.75
20408,Santa María del Rosario,430,414,441,480,246,236,482,441.25
20409,Santa María del Tule,7182,7272,8259,8165,4139,4779,8918,7719.5
20410,Santa María Ecatepec,3608,3369,3635,3461,1654,1699,3353,3518.25
20411,Santa María Guelacé,729,759,710,816,369,444,813,753.5
20412,Santa María Guienagati,2794,3021,2911,3286,1551,1617,3168,3003
20413,Santa María Huatulco,25242,28327,33194,38629,22295,23385,45680,31348
20414,Santa María Huazolotitlán,9895,10118,10239,10794,5599,5801,11400,10261.5
20415,Santa María Ipalapa,4447,4910,4253,4888,2392,2598,4990,4624.5
20416,Santa María Ixcatlán,686,594,573,516,231,257,488,592.25
20417,Santa María Jacatepec,9242,9783,8936,9240,4444,5030,9474,9300.25
20418,Santa María Jalapa del Marqués,11242,10491,11123,11888,6442,6706,13148,11186
20419,Santa María Jaltianguis,657,598,569,575,226,273,499,599.75
20420,Santa María Lachixío,915,1070,1454,1680,860,984,1844,1279.75
20421,Santa María Mixtequilla,3787,4041,4239,4442,2189,2366,4555,4127.25
20422,Santa María Nativitas,800,770,607,681,269,316,585,714.5
20423,Santa María Nduayaco,660,606,568,550,233,233,466,596
20424,Santa María Ozolotepec,4085,4156,4023,3992,1883,2011,3894,4064
20425,Santa María Pápalo,1958,2081,2087,2209,1027,1059,2086,2083.75
20426,Santa María Peñoles,6758,6914,7640,7865,4165,4428,8593,7294.25
20427,Santa María Petapa,13037,13648,13867,15387,7864,8654,16518,13984.75
20428,Santa María Quiegolani,1500,1506,1537,1770,964,960,1924,1578.25
20429,Santa María Sola,1741,1675,1490,1524,717,754,1471,1607.5
20430,Santa María Tataltepec,293,272,303,253,173,187,360,280.25
20431,Santa María Tecomavaca,1888,1831,1683,1774,818,874,1692,1794
20432,Santa María Temaxcalapa,933,958,924,968,450,451,901,945.75
20433,Santa María Temaxcaltepec,1673,2219,2628,2595,1206,1365,2571,2278.75
20434,Santa María Teopoxco,3965,4843,4436,4651,1943,2271,4214,4473.75
20435,Santa María Tepantlali,2453,2752,2315,3505,1693,1772,3465,2756.25
20436,Santa María Texcatitlán,1122,1204,911,1113,467,514,981,1087.5
20437,Santa María Tlahuitoltepec,6982,8406,9000,9663,4248,4674,8922,8512.75
20438,Santa María Tlalixtac,1479,1562,1568,1754,806,829,1635,1590.75
20439,Santa María Tonameca,16546,20228,21223,24318,12378,12752,25130,20578.75
20440,Santa María Totolapilla,1112,1016,878,896,403,436,839,975.5
20441,Santa María Xadani,5848,5698,7283,7781,4340,4455,8795,6652.5
20442,Santa María Yalina,414,378,292,354,125,142,267,359.5
20443,Santa María Yavesía,479,460,409,448,212,260,472,449
20444,Santa María Yolotepec,575,469,431,461,190,221,411,484
20445,Santa María Yosoyúa,1371,1223,1284,1642,748,766,1514,1380
20446,Santa María Yucuhiti,6335,6565,6496,6551,2870,3178,6048,6486.75
20447,Santa María Zacatepec,14822,15417,13734,15076,7756,8584,16340,14762.25
20448,Santa María Zaniza,1296,1633,1818,2009,1063,1171,2234,1689
20449,Santa María Zoquitlán,4086,3449,3163,3359,1441,1498,2939,3514.25
20450,Santiago Amoltepec,8576,9537,11113,12313,6100,6583,12683,10384.75
20451,Santiago Apoala,1321,1365,815,1053,406,469,875,1138.5
20452,Santiago Apóstol,4761,4636,3825,4220,1799,2196,3995,4360.5
20453,Santiago Astata,2606,2577,3642,3915,1848,1860,3708,3185
20454,Santiago Atitlán,2475,2754,3187,3180,1453,1467,2920,2899
20455,Santiago Ayuquililla,2242,2404,2261,2748,1217,1366,2583,2413.75
20456,Santiago Cacaloxtepec,1275,1341,1496,1686,691,750,1441,1449.5
20457,Santiago Camotlán,3019,3058,3089,3395,1488,1594,3082,3140.25
20458,Santiago Comaltepec,1752,1544,1386,1115,456,511,967,1449.25
20459,Santiago Chazumba,4600,4314,4209,4479,1937,2434,4371,4400.5
20460,Santiago Choápam,4241,4837,4979,5413,2384,2599,4983,4867.5
20461,Santiago del Río,921,725,543,614,242,276,518,700.75
20462,Santiago Huajolotitlán,4555,3988,4014,4350,1888,2195,4083,4226.75
20463,Santiago Huauclilla,976,933,607,663,248,281,529,794.75
20464,Santiago Ihuitlán Plumas,625,601,419,480,153,198,351,531.25
20465,Santiago Ixcuintepec,1236,1200,1441,1568,774,824,1598,1361.25
20466,Santiago Ixtayutla,8732,10675,11542,11917,6278,6763,13041,10716.5
20467,Santiago Jamiltepec,17794,17922,17206,18383,9134,10067,19201,17826.25
20468,Santiago Jocotepec,11331,12682,12423,13568,6910,7225,14135,12501
20469,Santiago Juxtlahuaca,29416,28118,33401,32927,17285,18990,36275,30965.5
20470,Santiago Lachiguiri,5873,6336,4361,4693,2445,2441,4886,5315.75
20471,Santiago Lalopa,507,520,414,496,250,248,498,484.25
20472,Santiago Laollaga,2883,2788,2716,3198,1642,1684,3326,2896.25
20473,Santiago Laxopa,1519,1432,1282,1394,608,684,1292,1406.75
20474,Santiago Llano Grande,3449,3291,3021,3260,1633,1651,3284,3255.25
20475,Santiago Matatlán,7993,8759,9198,9653,4498,5183,9681,8900.75
20476,Santiago Miltepec,424,397,265,409,189,204,393,373.75
20477,Santiago Minas,1721,1674,1504,1430,705,740,1445,1582.25
20478,Santiago Nacaltepec,2700,2422,1967,1913,842,943,1785,2250.5
20479,Santiago Nejapilla,296,266,195,219,104,98,202,244
20480,Santiago Nundiche,1038,1028,869,967,412,465,877,975.5
20481,Santiago Nuyoó,2975,2876,2173,1966,868,952,1820,2497.5
20482,Santiago Pinotepa Nacional,42116,44193,44441,50309,25833,27315,53148,45264.75
20483,Santiago Suchilquitongo,6828,7937,8518,9542,4985,5412,10397,8206.25
20484,Santiago Tamazola,3185,4469,3950,4207,2015,2235,4250,3952.75
20485,Santiago Tapextla,3473,3234,2810,3031,1623,1585,3208,3137
20486,Villa Tejúpam de la Unión,2201,2306,2177,2469,1149,1254,2403,2288.25
20487,Santiago Tenango,1672,1721,1782,1945,995,1000,1995,1780
20488,Santiago Tepetlapa,132,140,116,131,50,64,114,129.75
20489,Santiago Tetepec,4825,4997,4708,4953,2495,2499,4994,4870.75
20490,Santiago Texcalcingo,2480,2712,2781,3076,1479,1619,3098,2762.25
20491,Santiago Textitlán,2717,3315,3929,4170,2198,2206,4404,3532.75
20492,Santiago Tilantongo,4117,3888,3348,3210,1349,1607,2956,3640.75
20493,Santiago Tillo,512,506,472,553,242,281,523,510.75
20494,Santiago Tlazoyaltepec,4512,4330,4357,4894,2108,2554,4662,4523.25
20495,Santiago Xanica,3285,3267,2829,2884,1552,1549,3101,3066.25
20496,Santiago Xiacuí,1934,1762,1681,2171,828,908,1736,1887
20497,Santiago Yaitepec,3242,3130,3665,4122,1980,2372,4352,3539.75
20498,Santiago Yaveo,6696,6599,5503,6665,3430,3455,6885,6365.75
20499,Santiago Yolomécatl,1729,1725,1912,2021,955,1135,2090,1846.75
20500,Santiago Yosondúa,7660,7544,7197,7883,3904,4426,8330,7571
20501,Santiago Yucuyachi,1311,1173,742,940,456,480,936,1041.5
20502,Santiago Zacatepec,5136,4963,4871,5515,2537,2650,5187,5121.25
20503,Santiago Zoochila,471,465,440,374,196,206,402,437.5
20504,Nuevo Zoquiápam,1690,1757,1486,1652,797,857,1654,1646.25
20505,Santo Domingo Ingenio,8091,7295,7299,7554,3949,4016,7965,7559.75
20506,Santo Domingo Albarradas,827,755,747,782,355,400,755,777.75
20507,Santo Domingo Armenta,3246,3347,3022,3224,1722,1747,3469,3209.75
20508,Santo Domingo Chihuitán,1438,1488,1383,1521,722,764,1486,1457.5
20509,Santo Domingo de Morelos,6496,8725,8751,10547,5112,5626,10738,8629.75
20510,Santo Domingo Ixcatlán,857,878,1582,877,288,364,652,1048.5
20511,Santo Domingo Nuxaá,3141,3430,3253,3610,1528,1596,3124,3358.5
20512,Santo Domingo Ozolotepec,1114,1125,962,913,421,449,870,1028.5
20513,Santo Domingo Petapa,7786,7379,7583,8394,4607,4550,9157,7785.5
20514,Santo Domingo Roayaga,831,950,863,997,486,534,1020,910.25
20515,Santo Domingo Tehuantepec,52142,53229,57163,61872,31016,33623,64639,56101.5
20516,Santo Domingo Teojomulco,4044,4334,3992,4571,2482,2611,5093,4235.25
20517,Santo Domingo Tepuxtepec,2710,4004,3714,5194,2216,2599,4815,3905.5
20518,Santo Domingo Tlatayápam,161,160,146,153,60,72,132,155
20519,Santo Domingo Tomaltepec,2679,2834,2303,2790,1477,1511,2988,2651.5
20520,Santo Domingo Tonalá,6631,7308,6535,7153,3285,3636,6921,6906.75
20521,Santo Domingo Tonaltepec,347,327,291,276,113,122,235,310.25
20522,Santo Domingo Xagacía,1027,1041,928,1213,495,535,1030,1052.25
20523,Santo Domingo Yanhuitlán,1630,1565,1472,1609,703,800,1503,1569
20524,Santo Domingo Yodohino,573,510,441,369,158,156,314,473.25
20525,Santo Domingo Zanatepec,10153,10457,10716,11218,6022,6139,12161,10636
20526,Santos Reyes Nopala,11403,14058,14504,15986,8411,9172,17583,13987.75
20527,Santos Reyes Pápalo,2300,2569,2647,2829,1209,1391,2600,2586.25
20528,Santos Reyes Tepejillo,1595,1464,1125,1213,422,558,980,1349.25
20529,Santos Reyes Yucuná,1345,1456,1322,1332,679,701,1380,1363.75
20530,Santo Tomás Jalieza,2822,3095,2885,3385,1703,1914,3617,3046.75
20531,Santo Tomás Mazaltepec,2021,1939,1878,2333,1261,1371,2632,2042.75
20532,Santo Tomás Ocotepec,3939,4139,3789,4076,1740,1965,3705,3985.75
20533,Santo Tomás Tamazulapan,1633,1683,1853,2191,1025,1107,2132,1840
20534,San Vicente Coatlán,3587,4173,3378,3964,1808,2115,3923,3775.5
20535,San Vicente Lachixío,2870,3390,3154,2976,1377,1584,2961,3097.5
20536,San Vicente Nuñú,568,519,469,493,193,220,413,512.25
20537,Silacayoápam,8293,7786,6486,6747,3032,3463,6495,7328
20538,Sitio de Xitlapehua,634,635,705,705,309,360,669,669.75
20539,Soledad Etla,3352,3902,4187,5025,2714,2877,5591,4116.5
20540,Villa de Tamazulápam del Progreso,6202,6088,6638,7059,3611,4096,7707,6496.75
20541,Tanetze de Zaragoza,1821,1855,1581,1707,772,850,1622,1741
20542,Taniche,990,874,739,746,376,449,825,837.25
20543,Tataltepec de Valdés,4954,5306,5377,5561,2819,3050,5869,5299.5
20544,Teococuilco de Marcos Pérez,1729,1747,1237,1106,473,543,1016,1454.75
20545,Teotitlán de Flores Magón,7084,7476,8675,8966,4593,5283,9876,8050.25
20546,Teotitlán del Valle,5330,5562,5601,5638,2754,3030,5784,5532.75
20547,Teotongo,1154,952,937,951,426,505,931,998.5
20548,Tepelmeme Villa de Morelos,1645,1573,1455,1734,733,874,1607,1601.75
20549,"Heroica Villa Tezoatlán de Segura y Luna, Cuna de la Independencia de Oaxaca",12008,12346,11020,11319,5105,5929,11034,11673.25
20550,San Jerónimo Tlacochahuaya,4694,4724,4679,5076,2587,2904,5491,4793.25
20551,Tlacolula de Matamoros,12733,13507,16510,19625,10547,11998,22545,15593.75
20552,Tlacotepec Plumas,572,514,468,510,212,226,438,516
20553,Tlalixtac de Cabrera,6042,6777,8378,9417,4803,5405,10208,7653.5
20554,Totontepec Villa de Morelos,5438,5626,4780,5598,2568,2793,5361,5360.5
20555,Trinidad Zaachila,2833,2813,2809,2653,1427,1605,3032,2777
20556,La Trinidad Vista Hermosa,393,316,235,249,118,142,260,298.25
20557,Unión Hidalgo,12910,12140,12983,13970,7418,7929,15347,13000.75
20558,Valerio Trujano,1631,1507,1502,1543,627,744,1371,1545.75
20559,San Juan Bautista Valle Nacional,22276,22886,21189,22446,10883,11816,22699,22199.25
20560,Villa Díaz Ordaz,5791,5594,5859,6174,3049,3597,6646,5854.5
20561,Yaxe,2003,2256,2442,2683,1360,1429,2789,2346
20562,Magdalena Yodocono de Porfirio Díaz,1447,1305,1195,1458,758,796,1554,1351.25
20563,Yogana,1807,1413,1160,1308,580,684,1264,1422
20564,Yutanduchi de Guerrero,1313,1259,1175,1292,528,601,1129,1259.75
20565,Villa de Zaachila,15512,19247,28003,34101,20606,22673,43279,24215.75
20566,San Mateo Yucutindoo,2688,3184,3252,3034,1500,1510,3010,3039.5
20567,Zapotitlán Lagunas,2915,3433,3098,3133,1503,1639,3142,3144.75
20568,Zapotitlán Palmas,1551,1563,1373,1514,658,773,1431,1500.25
20569,Santa Inés de Zaragoza,2061,1958,1649,1707,759,857,1616,1843.75
20570,Zimatlán de Álvarez,16311,16801,18370,19215,9271,10578,19849,17674.25
